4---0---1---7
-   -   -   -
3---5---2---3
-   -   -   -
6---0---3---8