4---0---1---2
-   -   -   -
3---2---0---3
-   -   -   -
4---2---3---5