3---0---1---2
-   +   +   -
2---5+++0+++5
+   -   +   -
4---2---3---4